man 	woman
men 	women 
mens	womens
men's	women's
men-	women-
 men	 women
men,	women,
male	female
male	women
boy	girl
father	mother
son	daughter
uncle	aunt
brother	sister
fiancé	fiancée
husband	wife
husbands	wives
bridegroom	bride
nephew	niece
masculine	feminine
gay man	lesbian
gay men	lesbians
gay men's	lesbians'
gay fathers	lesbian mothers
