Male language (Ethiopia)	Ethiopia--Languages
Gingerbread men	Gingerbread
Deaf gay men	Deaf gay people
Male pregnancy	Pregnancy
Male early childhood teachers	Early childhood teachers
Men's wrist watches	Wrist watches
Men's underwear	Underwear
Male high school teachers	High school teachers
Male reproductive health	Reproductive health
Male reproductive health services	Reproductive health services
Male junior high school athletes	Junior high school athletes
Male cross-country runners	Cross-country runners
Male quiltmakers	Quiltmakers
Male beauty contests	Beauty contests
Male cheerleaders	Cheerleaders
Male fans	Fans (Persons)
Ballet dancing for men	Ballet dancing
Climacteric, Male	Climacteric
Male homosexuality	Homosexuality
Gay men	Gay people
Men's shirt industry	Shirt industry
Male prostitution	Prostitution
Short men	Short people
Male striptease	Striptease
Male contraception	Contraception
Male contraceptives	Contraceptives
Male actors	Actors
Male sterility in plants	Sterility in plants
Older gay men	Older gay people
Male rape victims	Rape victims
Male rape	Rape
Male models	Models (Persons)
Male elementary school teachers	Elementary school teachers
Male prostitutes	Prostitutes
Male sexual abuse victims	Sexual abuse victims
Men's choral societies	Choral societies
Male child care workers	Child care workers
Male primary school teachers	Primary school teachers
Male feminists	Feminists
Middle-aged gay men	Middle-aged gay people
Motion pictures and gay men	Gay people in motion pictures
Hispanic American young men	Hispanic American young adults
African American gay men	African American gay people
Gay men in motion pictures	Gay people in motion pictures
Jewish gay men	Jewish gay people
Gay men, Black	Gay people, Black
Gay men's writings, South African (English)	Gay people's writings, South African (English)
Male homosexuality in music	Homosexuality in music
Catholic gay men	Catholic gay people
Christian gay men	Christian gay people
Male homosexuality in motion pictures	Homosexuality in motion pictures
Gay men's writings, Scottish	Gay people's writings, Scottish
Emotional maturity in men	Emotional maturity
Interpersonal communication in men	Interpersonal communication
Asian American gay men	Asian American gay people
Muslim gay men	Muslim gay people
Male rape in literature	Rape in literature
Presbyterian gay men	Presbyterian gay people
Asian American men in popular culture	Asian Americans in popular culture
Male rape in art	Rape in art
Arab American men in literature	Arab American literature
Male homosexuality in the theater	Homosexuality in the theater
Hispanic American gay men	Hispanic American gay people
Church work with African American men	Church work with African Americans
Men, White, on television	White people on television
Working class men on television	Working class on television
Gay men in comics	Gay people in comics
Gay men in advertising	Gay people in advertising
Italian American gay men	Italian American gay people
Mexican American gay men	Mexican American gay people
Minority gay men	Minority gay people
Parents of gay men	Parents of gay people
Leopard men	Leopard
Oral contraceptives, Male	Oral contraceptives
Rickshaw men	Rickshaws
Sandwich men	Sandwiches
Gay men's writings, German	Gay people's writings, German
Gay men's writings, Latin American	Gay people's writings, Latin American
Gay men's writings, Canadian	Gay people's writings, Canadian
Gay men's writings, French	Gay people's writings, French
Gay men's writings, Italian	Gay people's writings, Italian
Gay men's writings	Gay people's writings
Gay men's writings, American	Gay people's writings, American
Gay men's writings, English	Gay people's writings, English
Gay men's writings, Australian	Gay people's writings, Australian
Middle class men in literature	Middle class in literature
Cosmetics for men	Cosmetics
Gay men in literature	Gay people in literature
Male homosexuality in art	Homosexuality and art
Male homosexuality in literature	Homosexuality and literature
Gay men's writings, Irish	Gay people's writings, Irish
Nigerian American men	Nigerian Americans
Gay men in mass media	Mass media and gay people
