Women marine mammalogists	Marine mammalogists
Women dermatologists	Dermatologists
Women librettists	Librettists
Women insurance agents	Insurance agents
Women personal trainers	Personal trainers
Women tap dancers	Tap dancers
Women mammalogists	Mammalogists
Women museum directors	Museum directors
Women dairy farmers	Dairy farmers
Women wood-pulp industry workers	Wood-pulp industry workers
Women religious Zionists	Religious Zionists
Women transport workers	Transport workers
Women war criminals	War criminals
Female sex offenders	Sex offenders
Women-owned law firms	Law firms
Separated women	Separated people
Women public relations personnel	Public relations personnel
Women military cadets	Military cadets
Women dressmakers	Dressmakers
Women conductors (Music)	Conductors (Music)
Women violists	Violists
Women violinists	Violinists
Women fascists	Fascists
Women's periodicals, Persian	Persian periodicals
Women in economic development	Economic development
Women forensic scientists	Forensic scientists
Women's periodicals, Lithuanian	Lithuanian periodicals
Women football players	Football players
Women illustrators	Illustrators
Women horse dealers	Horse dealers
Women telegraphers	Telegraphers
Jewish women authors	Jewish authors
Women religious leaders	Religious leaders
Women amusement ride owners	Amusement ride owners
Women in higher education	Education, Higher
Women migrant labor	Migrant labor
Women epigraphists	Epigraphists
Women in sustainable development	Sustainable development
Women musicologists	Musicologists
Indian women veterans	Indian veterans
Indian women teachers	Indian teachers
Women otolaryngologists	Otolaryngologists
Women's wit and humor	Wit and humor
Jewish women soldiers	Jewish soldiers
Young women with disabilities	Young adults with disabilities
Women balloonists	Balloonists
Women local officials and employees	Local officials and employees
Women squash players	Squash players
Indian women poets	Indian poets
Female gangs	Gangs
Women's periodicals, Finnish	Finnish periodicals
Women hockey coaches	Hockey coaches
Exiled women authors	Authors, Exiled
Female gang members	Gang members
Women in physics	Physics
Women suicide bombers	Suicide bombers
Women disaster victims	Disaster victims
Pueblo women potters	Pueblo potters
Indian women civic leaders	Indian civic leaders
Women rock music fans	Rock music fans
Women smokejumpers	Smokejumpers
Women death row inmates	Death row inmates
Women tortilla industry employees	Tortilla industry--Employees
Women sociology students	Sociology students
Women's periodicals, Tamil	Tamil periodicals
Women presidential candidates	Presidential candidates
Women anesthesiologists	Anesthesiologists
Women hosiery workers	Hosiery workers
Women gold miners	Gold miners
Women marines	Marines
Women netball players	Netball players
Women anti-apartheid activists	Anti-apartheid activists
Jewish women physicians	Jewish physicians
Women fire lookouts	Fire lookouts
Jewish women philosophers	Jewish philosophers
Women baseball team owners	Baseball team owners
Women poisoners	Poisoners
Minority women teachers	Minority teachers
Women school supervisors	School supervisors
Women police chiefs	Police chiefs
Women's police stations	Police stations
Women field hockey players	Field hockey players
Catholic women artists	Catholic artists
Women medievalists	Medievalists
Women's shoes	Shoes
Women in tourism	Tourism
Women performance artists	Performance artists
Women bounty hunters	Bounty hunters
Women humorists	Humorists
Women industrialists	Industrialists
Women moneylenders	Moneylenders
Medically uninsured women	Medically uninsured persons
Women coffee industry employees	Coffee industry--Employees
Catholic women authors	Catholic authors
Women in video games	Video games
Women gynecologists	Gynecologists
Women air traffic controllers	Air traffic controllers
Women Asianists	Asianists
Women Middle East specialists	Middle East specialists
Women's periodicals, African	African periodicals
Women poker players	Poker players
Women break dancers	Break dancers
Women war correspondents	War correspondents
Women bishops	Bishops
Women pianists	Pianists
Women television writers	Television writers
Women's periodicals, Philippine	Philippine periodicals
Female assassins	Assassins
Women forensic pathologists	Forensic pathologists
Female masturbation	Masturbation
Older women automobile drivers	Older automobile drivers
Women figure skaters	Figure skaters
Women prisoners of war	Prisoners of war
Women in fisheries	Fisheries
Women (Assyro-Babylonian law)	Law, Assyro-Babylonian
Women's restrooms	Restrooms
Women jewelers	Jewelers
Women organists	Organists
Women radio producers and directors	Radio producers and directors
Women vintners	Vintners
Minority women college administrators	Minority college administrators
Indian women activists	Indian activists
Women and anarchism	Anarchism
Racially mixed women	Racially mixed people
Women in Tantrism	Tantrism
Women harpsichordists	Harpsichordists
Women Nobel Prize winners	Nobel Prize winners
Women oceanographers	Oceanographers
Women and Christian union	Christian union
Female infanticide	Infanticide
Women Indianists	Indianists
Women choreographers	Choreographers
Women fantasy gamers	Fantasy gamers
Women daredevils	Daredevils
Women taxicab drivers	Taxicab drivers
Women motion picture editors	Motion picture editors
Women drug addicts	Drug addicts
Métis women artists	Métis artists
Jewish women college teachers	Jewish college teachers
Women skiers	Skiers
Women's periodicals, Czech	Czech periodicals
Women glassworkers	Glassworkers
Women conservatives	Conservatives
Women's periodicals, Thai	Thai periodicals
Women's periodicals, New Zealand	New Zealand periodicals
Women community health aides	Community health aides
Women athletic trainers	Athletic trainers
Women gladiators	Gladiators
Jewish women librarians	Jewish librarians
Women musical theater producers and directors	Musical theater producers and directors
Assyrian women	Assyrians
Women Nazis	Nazis
Women tattoo artists	Tattoo artists
Women Arabists	Arabists
Women commercial artists	Commercial artists
Women pharmacists	Pharmacists
Women psychics	Psychics
Women rap musicians	Rap musicians
Women soccer referees	Soccer referees
Latter Day Saint women missionaries	Latter Day Saint missionaries
Women television viewers	Television viewers
Women community college presidents	Community college presidents
Women cigar makers	Cigar makers
Women in natural resources management	Natural resources--Management
Women radio talk show hosts	Radio talk show hosts
Women in Zoroastrianism	Zoroastrianism
Women team handball players	Team handball players
Women plantation workers	Plantation workers
Women philologists	Philologists
Indian women air pilots	Indian air pilots
Women hermits	Hermits
Women ethnobotanists	Ethnobotanists
Women's periodicals, Irish	Irish periodicals
Women chief information officers	Chief information officers
Female high school athletes	High school athletes
Women typographers	Typographers
Women tomato industry employees	Tomato industry--Employees
Women's periodicals, Slovenian	Slovenian periodicals
Female middle school athletes	Middle school athletes
Women and human security	Human security
Quaker women missionaries	Quaker missionaries
Women amusement park owners	Amusement park owners
Indian women educators	Indian educators
Women torturers	Torturers
Women soccer fans	Soccer fans
Women theater critics	Theater critics
Exiled women dancers	Exiled dancers
Women ascetics	Ascetics
Sedentary women	Sedentary people
Women in biodiversity conservation	Biodiversity conservation
Older women athletes	Older athletes
Women economics historians	Economics historians
Women volunteers	Volunteers
Women crab industry employees	Crab industry--Employees
Women imams (Mosque officers)	Imams (Mosque officers)
Women alternative country musicians	Alternative country musicians
Women internal migrants	Internal migrants
Women opera producers and directors	Opera producers and directors
Women carpenters	Carpenters
Women sportscasters	Sportscasters
Women basket makers	Basket makers
Aleut women basket makers	Aleut basket makers
Women professional employees	Professional employees
Jewish women philanthropists	Jewish philanthropists
Women orienteers	Orienteers
Women Olympic athletes	Olympic athletes
Women's periodicals, Australian	Australian periodicals
Jewish women athletes	Jewish athletes
Women beekeepers	Beekeepers
Women in disaster relief	Disaster relief
Women sport psychologists	Sport psychologists
Women television news anchors	Television news anchors
Muslim women authors	Muslim authors
Tzeltal women weavers	Tzeltal weavers
Women drag racers	Drag racers
Women sufis	Sufis
Women goldsmiths	Goldsmiths
Women in energy development	Energy development
Female honeybees	Honeybee
Women sports spectators	Sports spectators
Women superheroes	Superheroes
Jewish women basketball players	Jewish basketball players
Mixtec women weavers	Mixtec weavers
Indian women basket makers	Indian basket makers
Women puppeteers	Puppeteers
Women personnel directors	Personnel directors
Jewish women photographers	Jewish photographers
Women's periodicals, Hindi	Hindi periodicals
Women roller skaters	Roller skaters
Women insurance investigators	Insurance investigators
Indian women photographers	Indian photographers
Women temporary employees	Temporary employees
Women sadhus	Sadhus
Women's periodicals, Kurdish	Kurdish periodicals
Jewish women cartoonists	Jewish cartoonists
Latter Day Saint women authors	Latter Day Saint authors
Women Kapos	Kapos
Tattooed women	Tattooed people
Women mathematics teachers	Mathematics teachers
Indian women jewelers	Indian jewelers
Women parolees	Parolees
Women doctoral students	Doctoral students
Indian women college students	Indian college students
Women in musical theater	Musical theater
Indian women sculptors	Indian sculptors
Indian women entertainers	Indian entertainers
Women directors of corporations	Directors of corporations
Indian women painters	Indian painters
Women midwives	Midwives
Minority women college teachers	Minority college teachers
Women noncitizens	Noncitizens
Women tourists	Tourists
Nahua women weavers	Nahua weavers
Women athletes with disabilities	Athletes with disabilities
Women's bands (Music)	Bands (Music)
Women fakirs	Fakirs
Women's periodicals, Serbian	Serbian periodicals
Women ski jumpers	Ski jumpers
Women bass guitarists	Bass guitarists
Women guitarists	Guitarists
Women punk rock musicians	Punk rock musicians
Women alternative rock musicians	Alternative rock musicians
Women video gamers	Video gamers
Women snowboarders	Snowboarders
Women video game designers	Video game designers
Women cricket players	Cricket players
Women triathletes	Triathletes
Women ambulance drivers	Ambulance drivers
Jewish women comedians	Jewish comedians
Women sexologists	Sexologists
Women skateboarders	Skateboarders
Women football coaches	Football coaches
Women sports executives	Sports executives
Women lithographers	Lithographers
Women water-skiers	Water-skiers
Women computer artists	Computer artists
Women sound recording executives and producers	Sound recording executives and producers
Women muralists	Muralists
Women in lexicography	Lexicography
Women (Ancient law)	Law, Ancient
Women American loyalists	American loyalists
Women ragpickers	Ragpickers
Women atomic bomb victims	Atomic bomb victims
Women jewel thieves	Jewel thieves
Women sound engineers	Sound engineers
Women sprinters	Sprinters
Minority women activists	Minority activists
Women and design	Design
Women slaveholders	Slaveholders
Women polo players	Polo players
Women in peace-building	Peace-building
Women popular music fans	Popular music fans
Women occultists	Occultists
Women hikers	Hikers
Women antiheroes	Antiheroes
Women internment camp guards	Internment camp guards
Women Nazi concentration camp guards	Nazi concentration camp guards
Women internment camp inmates	Internment camp inmates
Women Nazi concentration camp inmates	Nazi concentration camp inmates
Women litigants	Litigants
Women woodworkers	Woodworkers
Women's periodicals, Yugoslav	Yugoslav periodicals
Women independent filmmakers	Independent filmmakers
Women bank robbers	Bank robbers
Women baseball fans	Baseball fans
Women regents	Regents
Indian women dancers	Indian dancers
Women volunteers in agriculture	Volunteer workers in agriculture
Women exhibitors	Exhibitors
Female monsters	Monsters
Women's periodicals, Southern European	Southern European periodicals
Women genocide survivors	Genocide survivors
Indian women prisoners	Indian prisoners
Autistic women	Autistic people
Women graphic artists	Graphic artists
Women radio broadcasters	Radio broadcasters
Successful women	Successful people
Women cigarette smokers	Cigarette smokers
Female wolves	Wolves
Women spiritualists	Spiritualists
Women print dealers	Print dealers
Women cardiologists	Cardiologists
Women Muslim scholars	Muslim scholars
Women technologists	Technologists
Women flute players	Flute players
Women stringed instrument players	Stringed instrument players
Women with attention-deficit hyperactivity disorder	People with attention-deficit hyperactivity disorder
Women magicians	Magicians
Women anthropologists	Anthropologists
Women's bookplates	Bookplates
Christian women saints	Christian saints
Women explorers	Explorers
Women folklorists	Folklorists
Women millionaires	Millionaires
Minority women college graduates	Minority college graduates
Minority women executives	Minority executives
Minority women in the professions	Minorities in the professions
Muslim women saints	Muslim saints
Reformatories for women	Reformatories
Women saints	Saints
Women with social disabilities	People with social disabilities
Women in war	War
Women (Adat law)	Adat law
Women (Canon law)	Canon law
Women (Greek law)	Law, Greek
Women (Hindu law)	Hindu law
Women (Islamic law)	Islamic law
Women (Jewish law)	Jewish law
Women (Roman law)	Roman law
Women, Prehistoric	Prehistoric peoples
Women in numismatics	Numismatics
Women (International law)	International law
Women accountants	Accountants
Women agricultural engineers	Agricultural engineers
Women agricultural laborers	Agricultural laborers
Women agriculturists	Agriculturists
Women air pilots	Air pilots
Women aircraft industry employees	Aircraft industry--Employees
Women and city planning	City planning
Women and freemasonry	Freemasonry
Women and journalism	Journalism
Women and land use planning	Land use--Planning
Women and peace	Peace
Women and psychoanalysis	Psychoanalysis
Women and religion	Religion
Women and socialism	Socialism
Women and war	War
Women animal specialists	Animal specialists
Women archaeologists	Archaeologists
Women architects	Architects
Women architectural critics	Architectural critics
Women art critics	Art critics
Women art dealers	Art dealers
Women art historians	Art historians
Women art teachers	Art teachers
Women artisans	Artisans
Women book collectors	Book collectors
Women inventors	Inventors
Women jurors	Jurors
Women orators	Orators
Women astronauts	Astronauts
Women authors, Japanese	Authors, Japanese
Women automobile drivers	Automobile drivers
Women automobile industry workers	Automobile industry workers
Women automobile racing drivers	Automobile racing drivers
Women bank employees	Bank employees
Women bankers	Bankers
Women basketball players	Basketball players
Women bodybuilders	Bodybuilders
Women bookplate designers	Bookplate designers
Women bookbinders	Bookbinders
Women broadcasters	Broadcasters
Women bullfighters	Bullfighters
Women calligraphers	Calligraphers
Women cannery workers	Cannery workers
Women cartoonists	Cartoonists
Women clergy	Clergy
Women clerks	Clerks
Women clerks (Retail trade)	Clerks (Retail trade)
Women clothing workers	Clothing workers
Women coal miners	Coal miners
Women college administrators	College administrators
Women college graduates	College graduates
Women college teachers	College teachers
Women colonial administrators	Colonial administrators
Women colonists	Colonists
Women composers	Composers
Women consultants	Consultants
Women correctional personnel	Correctional personnel
Women cytologists	Cytologists
Women dental students	Dental students
Women dentists	Dentists
Women designers	Designers
Women detectives	Detectives
Women diplomats	Diplomats
Women divers	Divers
Women household employees	Household employees
Women drywall contractors	Drywall contractors
Women economists	Economists
Women educators	Educators
Women electronic data processing personnel	Electronic data processing personnel
Women electronic industry workers	Electronic industry workers
Women engineers	Engineers
Women engravers	Engravers
Women entertainers	Entertainers
Women ethologists	Ethologists
Women evangelists	Evangelists
Women executives	Executives
Women farmers	Farmers
Women fishers	Fishers
Women gardeners	Gardeners
Women geneticists	Geneticists
Women geographers	Geographers
Women geologists	Geologists
Women government executives	Government executives
Women graduate students	Graduate students
Women guerrillas	Guerrillas
Women heads of households	Heads of households
Women heads of state	Heads of state
Women healers	Healers
Women historians	Historians
Women hymn writers	Hymn writers
Women in aeronautics	Aeronautics
Women in agriculture	Agriculture
Women in astronautics	Astronautics
Women in bookplates	Bookplates
Women in Buddhism	Buddhism
Women in chemistry	Chemistry
Women in Christianity	Christianity
Women in communication	Communication
Women in community development	Community development
Women in community organization	Community organization
Women in conservation of natural resources	Conservation of natural resources
Women in cooperative societies	Cooperative societies
Women in engineering	Engineering
Women in finance	Finance
Women in guilds	Guilds
Women in Hinduism	Hinduism
Women in horse racing	Horse racing
Women in horse sports	Horse sports
Women in information science	Information science
Women in Islam	Islam
Women in Jainism	Jainism
Women in Judaism	Judaism
Women in landscape architecture	Landscape architecture
Women in library science	Library science
Women in marketing	Marketing
Women in mathematics	Mathematics
Women in medicine	Medicine
Women in opera	Opera
Women in pharmacy	Pharmacy
Women in rabbinical literature	Rabbinical literature
Women in rodeos	Rodeos
Women in rural development	Rural development
Women in science	Science
Women in technology	Technology
Women in Latter Day Saint churches	Latter Day Saint churches
Women in television broadcasting	Television broadcasting
Women labor union members	Labor union members
Women information scientists	Information scientists
Women intellectuals	Intellectuals
Women iron and steel workers	Iron and steel workers
Women jazz musicians	Jazz musicians
Women jockeys	Jockeys
Women journalists	Journalists
Women judges	Judges
Women kindergarten teachers	Kindergarten teachers
Women landscape architects	Landscape architects
Women law students	Law students
Women legislators	Legislators
Women librarians	Librarians
Women mathematicians	Mathematicians
Women medical scientists	Medical scientists
Women medical students	Medical students
Women middle managers	Middle managers
Women miners	Miners
Women missionaries	Missionaries
Women molecular biologists	Molecular biologists
Women film critics	Film critics
Women motion picture producers and directors	Motion picture producers and directors
Women motorcyclists	Motorcyclists
Women mountaineers	Mountaineers
Women museum curators	Museum curators
Women mystics	Mystics
Women naturalists	Naturalists
Women novelists	Novelists
Women-owned architectural firms	Architectural firms
Women-owned business enterprises	Business enterprises
Women-owned engineering firms	Engineering firms
Women painters	Painters
Women philanthropists	Philanthropists
Women philosophers	Philosophers
Women photographers	Photographers
Women physicians	Physicians
Women physicists	Physicists
Women physiologists	Physiologists
Women pioneers	Pioneers
Women plantation owners	Plantation owners
Women poets	Poets
Women poets, Japanese	Poets, Japanese
Women political prisoners	Political prisoners
Women potters	Potters
Women priests	Priests
Women prime ministers	Prime ministers
Women printers	Printers
Women psychoanalysts	Psychoanalysts
Women psychologists	Psychologists
Women psychotherapists	Psychotherapists
Women railroad employees	Railroads--Employees
Women refugees	Refugees
Women revolutionaries	Revolutionaries
Women rice workers	Rice workers
Women rubber industry workers	Rubber industry workers
Women sales personnel	Sales personnel
Women scholars	Scholars
Women school administrators	School administrators
Women scientists	Scientists
Women sculptors	Sculptors
Women seminarians	Seminarians
Women skaters	Skaters
Enslaved women	Enslaved persons
Women social reformers	Social reformers
Women social scientists	Social scientists
Women soldiers	Soldiers
Women spies	Spies
Women statisticians	Statisticians
Women supervisors	Supervisors
Women surgeons	Surgeons
Women television personalities	Television personalities
Women tennis players	Tennis players
Women terrorists	Terrorists
Women textile workers	Textile workers
Women tobacco workers	Tobacco workers
Women track and field athletes	Track and field athletes
Women travelers	Travelers
Women truck drivers	Truck drivers
Women veterans	Veterans
Women veterinarians	Veterinarians
Women veterinary students	Veterinary students
Women volunteers in social service	Volunteer workers in social service
Women welders	Welders (Persons)
Women wrestlers	Wrestlers
Women's encyclopedias and dictionaries	Encyclopedias and dictionaries
Women's periodicals	Periodicals
Women's periodicals, American	American periodicals
Women's periodicals, Brazilian	Brazilian periodicals
Women's periodicals, Catalan	Catalan periodicals
Women's periodicals, English	English periodicals
Women's periodicals, European	European periodicals
Women's periodicals, French	French periodicals
Women's periodicals, French-Canadian	French-Canadian periodicals
Women's periodicals, German	German periodicals
Women's periodicals, Polish	Polish periodicals
Women's periodicals, Japanese	Japanese periodicals
Women's periodicals, Korean	Korean periodicals
Women's periodicals, Mexican	Mexican periodicals
Women's periodicals, Spanish	Spanish periodicals
Women's periodicals, Swedish	Swedish periodicals
Women metal-workers	Metal-workers
Women pirates	Pirates
Women outlaws	Outlaws
Women psychiatrists	Psychiatrists
Women sugar workers	Sugar workers
Women conservationists	Conservationists
Women mushers	Mushers
Women merchant mariners	Merchant mariners
Women city planners	City planners
Women merchants	Merchants
Women lace makers	Lace makers
Women Buddhist priests	Buddhist priests
Women chess players	Chess players
Women golfers	Golfers
Women oil industry workers	Oil industry workers
Women apprentices	Apprentices
Women loggers	Loggers
Women's television programs	Television programs
Women international relations specialists	International relations specialists
Women communists	Communists
Women bridge players	Bridge players
Women costume designers	Costume designers
Women textile designers	Textile designers
Women in combat	Combat
Women coffee plantation workers	Coffee plantation workers
Women salt workers	Salt workers
Women television producers and directors	Television producers and directors
Women chemists	Chemists
Women mayors	Mayors
Women foreign workers	Foreign workers
Women ranchers	Ranchers
Women county council members	County council members
Women archivists	Archivists
Women city council members	City council members
Women civic leaders	Civic leaders
Women tailors	Tailors
Women conscientious objectors	Conscientious objectors
Women art patrons	Art patrons
Women civil rights workers	Civil rights workers
Women astronomers	Astronomers
Women genealogists	Genealogists
Women bowlers	Bowlers
Women fuelwood gatherers	Fuelwood gatherers
Women patients	Patients
Women dog owners	Dog owners
Women socialists	Socialists
Women's periodicals, Swiss	Swiss periodicals
Women agricultural extension workers	Agricultural extension workers
Women sailors	Sailors
Women construction workers	Construction workers
Women and animals	Animals
Women political activists	Political activists
Women postal service employees	Postal service--Employees
Women generals	Generals
Women and spiritualism	Spiritualism
Women mediums	Mediums
Women in radio broadcasting	Radio broadcasting
Women music teachers	Music teachers
Women amputees	Amputees
Women canoeists	Canoeists
Women and communism	Communism
Women capitalists and financiers	Capitalists and financiers
Women's periodicals, Bolivian	Bolivian periodicals
Women-owned landscape architectural firms	Landscape architectural firms
Women college presidents	College presidents
Women theatrical producers and directors	Theatrical producers and directors
Women surveyors	Surveyors
Women drug dealers	Drug dealers
Women sociologists	Sociologists
Women anarchists	Anarchists
Women tea plantation workers	Tea plantation workers
Women primatologists	Primatologists
Women criminal justice personnel	Criminal justice personnel
Women entomologists	Entomologists
Women fashion designers	Fashion designers
Women abolitionists	Abolitionists
Women carcinologists	Carcinologists
Women pediatricians	Pediatricians
Women botanists	Botanists
Women zoologists	Zoologists
Women silversmiths	Silversmiths
Women alcoholics	Alcoholics
Women nutritionists	Nutritionists
Women wood-engravers	Wood-engravers
Women peasants	Peasants
Women cat owners	Cat owners
Women plant pathologists	Plant pathologists
Women school principals	School principals
Women Biblical scholars	Biblical scholars
Women park rangers	Park rangers
Women medical technologists	Medical technologists
Women human rights workers	Human rights workers
Women rowers	Rowers
Women brickmakers	Brickmakers
Women coaches (Athletics)	Coaches (Athletics)
Women's periodicals, Italian	Italian periodicals
Women interior decorators	Interior decorators
Women pipe fitters	Pipe fitters
Women cytogeneticists	Cytogeneticists
Women optometrists	Optometrists
Women history teachers	History teachers
Women physical education teachers	Physical education teachers
Women public officers	Public officers
Women rock musicians	Rock musicians
Women ex-convicts	Ex-convicts
Women translators	Translators
Women fire fighters	Fire fighters
Women labor leaders	Labor leaders
Women in Sikhism	Sikhism
Women environmentalists	Environmentalists
Women horse owners	Horse owners
Women baseball players	Baseball players
Women planners	Planners
Women editors	Editors
Women real estate agents	Real estate agents
Women test pilots	Test pilots
Women biologists	Biologists
Women copy writers	Copy writers
Women aerospace engineers	Aerospace engineers
Women periodical editors	Periodical editors
Women computer programmers	Computer programmers
Women church historians	Church historians
Minority women librarians	Minority librarians
Women cabinet officers	Cabinet officers
Women political scientists	Political scientists
Women biographers	Biographers
Women radicals	Radicals
Women newspaper editors	Newspaper editors
Women Jewish scholars	Jewish scholars
Women presidents	Presidents
Women in fundamentalist churches	Fundamentalist churches
Women jazz singers	Jazz singers
Women electric industry workers	Electric industry workers
Women industrial engineers	Industrial engineers
Women cleaning personnel	Cleaning personnel
Women music critics	Music critics
Women archaeology teachers	Archaeology teachers
Women classicists	Classicists
Women's bookstores	Bookstores
Women's music	Political consultants
Women political consultants	Stunt performers
Women stunt performers	Arabic periodicals
Women's periodicals, Arabic	Tantric Buddhism
Women in Tantric Buddhism	Turkish periodicals
Women's periodicals, Turkish	Radio writers
Women radio writers	Minority artists
Minority women artists	Gamblers
Women gamblers	Ghostwriters
Women ghostwriters	Libertarians
Women libertarians	Country musicians
Women country musicians	Intelligence officers
Women intelligence officers	Law, Byzantine
Women (Byzantine law)	Speechwriters
Women speechwriters	Astronomy
Women in astronomy	Parade float designers
Women parade float designers	Screenwriters
Women screenwriters	Agricultural economists
Women agricultural economists	Theatrical managers
Women theatrical managers	Nonprofit organizations
Women in nonprofit organizations	Coffee growers
Women coffee growers	Child molesters
Women child molesters	Sportswriters
Women sportswriters	Animators
Women animators	Chinese periodicals
Women's periodicals, Chinese	Housing management
Women in housing management	Physical therapists
Women physical therapists	Food service employees
Women food service employees	Law teachers
Women law teachers	Faroese periodicals
Women's periodicals, Faroese	Pacifists
Women pacifists	Lighthouse keepers
Women lighthouse keepers	Benefactors
Women benefactors	Ambassadors
Women ambassadors	Church officers
Women church officers	Analysands
Women analysands	Horticultural writers
Women horticultural writers	Democracy
Women and democracy	Ichthyologists
Women ichthyologists	Historians of science
Women historians of science	Historians of technology
Women historians of technology	Medical historians
Women medical historians	Curriculum consultants
Women curriculum consultants	Library trustees
Women library trustees	Deans (Education)
Women deans (Education)	Helicopter pilots
Women helicopter pilots	Shepherds
Women shepherds	Insurance
Women in insurance	Governors
Women governors	Marine engineers
Women marine engineers	Condoms
Female condoms	Botany
Women in botany	Prophets
Women prophets	Cantors (Judaism)
Women cantors (Judaism)	Health reformers
Women health reformers	Printmakers
Women printmakers	Indian artists
Indian women artists	Jaina saints
Jaina women saints	Philology
Women and philology	Medalists
Women medalists	Landowners
Women landowners	Library administrators
Women library administrators	Navajo shepherds
Navajo women shepherds	Engineering students
Women engineering students	Library employees
Women library employees	Science students
Women science students	Botanizers
Women botanizers	Pathologists
Women pathologists	Life scientists
Women life scientists	Minority lawyers
Minority women lawyers	Physician executives
Women physician executives	School superintendents
Women school superintendents	Bacteriologists
Women bacteriologists	Microbiologists
Women microbiologists	Physical scientists
Women physical scientists	Agricultural students
Women agricultural students	Earth scientists
Women earth scientists	Hindu saints
Hindu women saints	Bluegrass musicians
Women bluegrass musicians	Fiddlers
Women fiddlers	Indian authors
Indian women authors	Death
Women and death	Hop pickers
Women hop pickers	Serial murderers
Women serial murderers	Flamenco music
Women in flamenco music	Flamenco musicians
Women flamenco musicians	Brewery workers
Women brewery workers	Glass artists
Women glass artists	Fishing guides
Women fishing guides	Physical anthropologists
Women physical anthropologists	Inuit artists
Inuit women artists	Attorneys general
Women attorneys general	Water utilities--Employees
Women water utility employees	Heroes
Women heroes	Egyptologists
Women Egyptologists	Area specialists
Women area specialists	Specialists
Women specialists	Ethnologists
Women ethnologists	Paleontologists
Women paleontologists	Marine biologists
Women marine biologists	Aquatic biologists
Women aquatic biologists	Aquatic scientists
Women aquatic scientists	Rabbis
Women rabbis	Russian periodicals
Women's periodicals, Russian	Blues musicians
Women blues musicians	Insurance executives
Women insurance executives	Art students
Women art students	Brewers
Women brewers	Pomo weavers
Pomo women weavers	Gymnasts
Women gymnasts	Stockbrokers
Women stockbrokers	Hunters
Women hunters	Cinematographers
Women cinematographers	Circus performers
Women circus performers	Fencers
Women fencers	Surfers
Women surfers	Speed skaters
Women speed skaters	Tramps
Women tramps	Indian healers
Indian women healers	Politicians
Women politicians	Austrian periodicals
Women's periodicals, Austrian	Storytellers
Women storytellers	Type designers
Women type designers	Prayer groups
Women's prayer groups	Animal trainers
Women animal trainers	Volleyball players
Women volleyball players	Computer network resources
Women's computer network resources	Music by African American composers
Music by African American women composers	Accordionists
Women accordionists	Indian potters
Indian women potters	Critics
Women critics	Leather workers
Women leather workers	Computer industry--Employees
Women computer industry employees	Jewish artists
Jewish women artists	Christian educators
Women Christian educators	Martyrs
Women martyrs	Christian martyrs
Christian women martyrs	Theologians
Women theologians	Chief executive officers
Women chief executive officers	Biochemists
Women biochemists	Geophysicists
Women geophysicists	Marine scientists
Women marine scientists	Rodeo performers
Women rodeo performers	Political candidates
Women political candidates	Music patrons
Women music patrons	Cyclists
Women cyclists	Computer scientists
Women computer scientists	Confucianism
Women in Confucianism	Computational neuroscientists
Women computational neuroscientists	Food writers
Women food writers	Hopi potters
Hopi women potters	Tewa potters
Tewa women potters	Justices of the peace
Women justices of the peace	Parks--Employees
Women park employees	Ship captains
Women ship captains	Heart--Diseases
Heart diseases in women	Martial artists
Women martial artists	Shamans
Women shamans	Cartographers
Women cartographers	Erotica
Women and erotica	Deafblind people
Deafblind women	Soccer players
Women soccer players	Hockey players
Women hockey players	Freethinkers
Women freethinkers	Drummers (Musicians)
Women drummers (Musicians)	Operetta
Women in operetta	Embroidery industry--Employees
Women embroidery industry employees	Danish periodicals
Women's periodicals, Danish	Public worship
Women in public worship	Ukrainian periodicals
Women's periodicals, Ukrainian	Softball players
Women softball players	Canadian periodicals
Women's periodicals, Canadian	Tall people
Tall women	Hats
Women's hats	Transplant surgeons
Women transplant surgeons	Music
Women computer engineers	Computer engineers
Women admirals	Admirals
Women basketball coaches	Basketball coaches
Women election officials	Election officials
Women ecologists	Ecologists
Women in computer science	Computer science
Women television journalists	Television journalists
Women folk musicians	Folk musicians
Women swimmers	Swimmers
Women service industries workers	Service industries workers
Women forensic anthropologists	Forensic anthropologists
Women lyricists	Lyricists
Indian women physicians	Indian physicians
Women linguists	Linguists
Women fishery scientists	Fishery scientists
Women's music festivals	Music festivals
Women hunting guides	Hunting guides
Women bobsledders	Bobsledders
Women Assyriologists	Assyriologists
Women's periodicals, Dutch	Dutch periodicals
Women spiritual directors	Spiritual directors
Women beadworkers	Beadworkers
Women private investigators	Private investigators
Chilean American women	Chilean Americans
Boxing for women	Boxing
Women, Creole (Sierra Leone)	Creoles (Sierra Leone)
Spiritual retreats for women	Spiritual retreats
Surfing for women	Surfing
Women poets, Swedish	Poets, Swedish
Women poets, Bolivian	Poets, Bolivian
Infertility, Female, in literature	Infertility literature
Women poets, Canadian	Poets, Canadian
African American homeless women	African American homeless persons
Women poets, Puerto Rican	Poets, Puerto Rican
African American women household employees	African American household employees
African American women public relations personnel	African American public relations personnel
Women authors, Tamil	Authors, Tamil
Jewish religious education of women	Jewish religious education of adults
Etiquette for young women	Etiquette for young adults
Women authors, Venezuelan	Authors, Venezuelan
Women poets, Honduran	Poets, Honduran
African American women dramatists	African American dramatists
Women poets, Icelandic	Poets, Icelandic
Hispanic American women authors	Hispanic American authors
Internet and women	Internet
Women circus performers in literature	Circus performers in literature
Dutch American women	Dutch Americans
African American women on television	African Americans on television
Self-acceptance in women	Self-acceptance
Women novelists, South African	Novelists, South African
Older African American women	Older African Americans
African American women critics	African American critics
Women band directors	Band directors
Women authors, Cuban	Authors, Cuban
Women musicians in literature	Musicians in literature
Women dramatists, Scottish	Dramatists, Scottish
Fencing for women	Fencing
Women authors, Bolivian	Authors, Bolivian
Women poets, Turkish	Poets, Turkish
Women authors, Belgian	Authors, Belgian
Afghan American women	Afghan Americans
Women authors, Costa Rican	Authors, Costa Rican
Women heroes on television	Heroes on television
Women authors, Icelandic	Authors, Icelandic
Inupiat women	Inupiat
In-line skating for women	In-line skating
Women novelists, Canadian	Novelists, Canadian
African American women rock musicians	African American rock musicians
Women poets, Finnish	Poets, Finnish
Women dramatists, Canadian	Dramatists, Canadian
Women poets, Ecuadorian	Poets, Ecuadorian
Technology and women	Technology
Self-realization in women	Self-realization
Women novelists, New Zealand	Novelists, New Zealand
Women authors, Singaporean	Authors, Singaporean
Women poets, Australian	Poets, Australian
Women authors, Colombian	Authors, Colombian
Gentile women	Gentiles
Experience (Religion) in women	Experience (Religion)
Hispanic American women civic leaders	Hispanic American civic leaders
Women, Romani, in literature	Romani literature
Women authors, Turkish	Authors, Turkish
Sea kayaking for women	Sea kayaking
Women authors, Indonesian	Authors, Indonesian
Southeast Asian American women	Southeast Asian Americans
Women authors, Estonian	Authors, Estonian
Women authors, Bulgarian	Authors, Bulgarian
Women authors, Puerto Rican	Authors, Puerto Rican
Women poets, Telugu	Poets, Telugu
Muslim women in literature	Muslims in literature
Women dramatists, Australian	Dramatists, Australian
Women judges (Islamic law)	Judges (Islamic law)
Women authors, Peruvian	Authors, Peruvian
Women poets, Austrian	Poets, Austrian
Brahman women	Brahman
Church work with older women	Church work with older people
Hiking for women	Hiking
Women authors, Algerian	Authors, Algerian
African American women judges	African American judges
Women physicians in literature	Physicians in literature
Mexican American women labor union members	Mexican American labor union members
Mexican American women artists	Mexican American artists
African American women comedians	African American comedians
Mexican American women authors	Mexican American authors
Italian American women authors	Italian American authors
Women authors, Kenyan	Authors, Kenyan
Argentine American women	Argentine Americans
Women detectives in mass media	Detectives in mass media
Women lawyers in motion pictures	Lawyers in motion pictures
Physical fitness for middle-aged women	Physical fitness for middle-aged persons
Exercise for middle-aged women	Exercise for middle-aged persons
Women and war in literature	War and literature
Women dramatists, Arab	Dramatists, Arab
Women authors, Sierra Leonean	Authors, Sierra Leonean
Autoimmune diseases in women	Autoimmune diseases
College sports for women	College sports
Korean American women in literature	Korean Americans in literature
Women, Anglo-Indian	Anglo-Indians
Poker for women	Poker
Hispanic American women healers	Hispanic American healers
Asian American women college teachers	Asian American college teachers
Women saints in art	Saints in art
Women prophets in literature	Prophets in literature
Japanese American women soldiers	Japanese American soldiers
Chronic pain in women	Chronic pain
Women poets, Uruguayan	Poets, Uruguayan
Women poets, Cuban	Poets, Cuban
Women scientists in motion pictures	Scientists in motion pictures
Discounts for women	Discount
Mexican American women politicians	Mexican American politicians
Women poets, Portuguese	Poets, Portuguese
Dance for women	Dance
Break dancing for women	Break dancing
Baseball for women	Baseball
Women dramatists, Korean	Dramatists, Korean
Jamaican American women	Jamaican Americans
Women athletes in literature	Athletes in literature
Hispanic American women legislators	Hispanic American legislators
African American women civic leaders	African American civic leaders
Women authors, Czech	Authors, Czech
Swedish American women	Swedish Americans
Women college students in literature	College students in literature
Women authors, Nepali	Authors, Nepali
Creative ability in women	Creative ability
Women, Somali	Somalis
Women poets, Chilean	Poets, Chilean
Women dramatists, Mexican	Dramatists, Mexican
Women journalists in literature	Journalists in literature
Indian women in motion pictures	Indian motion pictures
Jewish women in art	Jewish art
Minority women in higher education	Minorities in higher education
Women authors, Cambodian	Authors, Cambodian
Women novelists, Chinese	Novelists, Chinese
Women novelists, Irish	Novelists, Irish
African American women evangelists	African American evangelists
Hispanic American women in mass media	Hispanic Americans in mass media
Mexican American women in motion pictures	Mexican Americans in motion pictures
Sudanese American women	Sudanese Americans
Lebanese American women	Lebanese Americans
Women authors, Croatian	Authors, Croatian
Hindu women in literature	Hindu literature
Women immigrants in literature	Immigrants in literature
Self-actualization (Psychology) in women	Self-actualization (Psychology)
Women heroes in motion pictures	Heroes in motion pictures
Self-management (Psychology) for women	Self-management (Psychology)
Women poets, Polish	Poets, Polish
Women musicians, Black	Musicians, Black
Women authors, Ugandan	Authors, Ugandan
Women authors, Gujarati	Authors, Gujarati
Women dramatists, Persian	Dramatists, Persian
Women, Yi, in art	Art, Yi
African American women cartoonists	African American cartoonists
Women prisoners in art	Prisoners in art
African American women golfers	African American golfers
Women poets, Slovenian	Poets, Slovenian
Women poets, Slovak	Poets, Slovak
Video games for women	Video games
Women poets, Azerbaijani	Poets, Azerbaijani
Racially mixed women in literature	Racially mixed people in literature
Asian American women authors	Asian American authors
Women poets, Hungarian	Poets, Hungarian
Women authors, Persian	Authors, Persian
Women, Ukrainian	Ukrainians
African American women librarians	African American librarians
African American women scholars	African American scholars
Filipino American women college students	Filipino American college students
Women authors, Zimbabwean	Authors, Zimbabwean
Indian women in art	Indian art
Muslim women in motion pictures	Muslims in motion pictures
Advertising and women	Advertising
Women authors, Uruguayan	Authors, Uruguayan
Dominican American women	Dominican Americans
Druze women	Druzes
Women presidents in motion pictures	Presidents in motion pictures
Women presidents on television	Presidents on television
Women air pilots in literature	Air pilots in literature
Tai chi for women	Tai chi
Women poets, Kurdish	Poets, Kurdish
Hispanic American women college students	Hispanic American college students
Zoroastrian women	Zoroastrians
Women authors, Romanian	Authors, Romanian
Inuit women in motion pictures	Inuit in motion pictures
Alaska Native women	Alaska Natives
Women poets, Indonesian	Poets, Indonesian
Women novelists, Brazilian	Novelists, Brazilian
Rugby football for women	Rugby football
Unitarian women	Unitarians
Women detectives in motion pictures	Detectives in motion pictures
Women poets, Venezuelan	Poets, Venezuelan
Inuit women in art	Inuit in art
Inuit women sculptors	Inuit sculptors
Women poets, Estonian	Poets, Estonian
Female juvenile delinquents in literature	Juvenile delinquents in literature
Cambodian American women	Cambodian Americans
Middle-aged women in literature	Middle-aged persons in literature
Reformed Church women	Reformed Church
Women soldiers in mass media	Soldiers in mass media
Women college teachers in literature	College teachers in literature
Hypertension in women	Hypertension
Violence in women in popular culture	Violence in popular culture
Women heroes in mass media	Heroes in mass media
Women novelists, Swedish	Novelists, Swedish
Women immigrants in motion pictures	Immigrants in motion pictures
Hispanic American women on television	Hispanic Americans on television
Hispanic American women in motion pictures	Hispanic American motion pictures
Women authors, Malay	Authors, Malay
Women, Anglo-Indian, in literature	Anglo-Indian literature
Women dramatists, Greek (Modern)	Dramatists, Greek (Modern)
Field hockey for women	Field hockey
Women soldiers on television	Soldiers on television
Women, Turkmen	Turkmen
Swiss American women	Swiss Americans
Working class women in motion pictures	Working class in motion pictures
Women, East Indian	East Indians
Women authors, Kurdish	Authors, Kurdish
Children of women drug addicts	Children of drug addicts
Women authors, Slovak	Authors, Slovak
Women poets, Pushto	Poets, Pushto
Women authors, Sri Lankan	Authors, Sri Lankan
Women, Adygei	Adygei
African American women track and field athletes	African American track and field athletes
African American women politicians	African American politicians
Women authors, Sindhi	Authors, Sindhi
Women authors, Albanian	Authors, Albanian
Women authors, Malayalam	Authors, Malayalam
Women poets in literature	Poets in literature
Hyperphagia in women	Hyperphagia
Women authors, Serbian	Authors, Serbian
Women poets, Uzbek	Poets, Uzbek
Samaritan women	Samaritans
Black Seminole women	Black Seminoles
French-Canadian women	French-Canadians
Women poets, Haitian	Poets, Haitian
African American women newspaper editors	African American newspaper editors
Women authors, Afghan	Authors, Afghan
Women authors, Palestinian Arab	Authors, Palestinian Arab
Women poets, Czech	Poets, Czech
Indian women artisans	Indian artisans
Women heroes in literature	Heroes in literature
Women poets, Mexican	Poets, Mexican
Women authors, Yiddish	Authors, Yiddish
Navajo women in art	Navajo arts
Women poets, Tamil	Poets, Tamil
African American women choreographers	African American choreographers
African American women photographers	African American photographers
African American women dancers	African American dancers
Women, Black, in popular culture	Black people in popular culture
Women, Ainu	Ainu
Women poets, Romanian	Poets, Romanian
Women, Cypriot	Cypriots
Russian American women	Russian Americans
Women authors, Turkmen	Authors, Turkmen
Ski jumping for women	Ski jumping
Women teachers, White	Teachers, White
Women superheroes in literature	Superheroes in literature
Women poets, Nicaraguan	Poets, Nicaraguan
Women athletes in art	Athletes in art
Women, Cook Islander	Cook Islanders
African American women basketball players	African American basketball players
African American women in television broadcasting	African Americans in television broadcasting
Women authors, Cameroonian	Authors, Cameroonian
Tumors in women	Tumors
Women in science on television	Science on television
Iraqi American women	Iraqi Americans
African American women pacifists	African American pacifists
African American women school administrators	African American school administrators
Shiite women	Shiites
Slovenian American women	Slovenian Americans
Older sexual minority women	Older sexual minorities
Women authors, Azerbaijani	Authors, Azerbaijani
Post-traumatic stress disorder in women	Post-traumatic stress disorder
Women authors, Pakistani	Authors, Pakistani
Older women authors	Older authors
Women poets, Belarusian	Poets, Belarusian
Women soldiers in motion pictures	Soldiers in motion pictures
Sleep apnea syndromes in women	Sleep apnea syndromes
Sleep disorders in women	Sleep disorders
Football for women	Football
Resilience (Personality trait) in women	Resilience (Personality trait)
Minority women in mass media	Minorities in mass media
African American women superheroes	African American superheroes
Indian women elders (Indigenous leaders)	Indian elders (Indigenous leaders)
Women saints in literature	Saints in literature
Women, Eurasian	Eurasians
Buddhist women in art	Buddhists in art
Women authors, Marathi	Authors, Marathi
Christian women saints in art	Christian saints in art
Women authors, Polish	Authors, Polish
Hispanic American women college teachers	Hispanic American college teachers
Women antiheroes on television	Antiheroes on television
Women dancers in art	Dancers in art
African American women television journalists	African American television journalists
African American women television producers and directors	African American television producers and directors
African American women fire fighters	African American fire fighters
Palestinian American women	Palestinian Americans
Women missionaries in literature	Missionaries in literature
Women superheroes in comics	Superheroes in comics
Bengali American women	Bengali Americans
Female monsters in comics	Monsters in comics
Sexual minority women in literature	Sexual minorities in literature
Sexual minority women in comics	Sexual minorities in comics
Muslim women superheroes	Muslim superheroes
Women, Afghan	Afghans
Women, Black, in comics	Black people in comics
African American sexual minority women	African American sexual minorities
Female monsters in literature	Monsters in literature
African American women architects	African American architects
Women authors, Malian	Authors, Malian
Women poets, Armenian	Poets, Armenian
Women authors, Armenian	Authors, Armenian
Sailing for women	Sailing
Women, Circassian, in literature	Circassian literature
Women, Circassian	Circassians
Loss (Psychology) in women	Loss (Psychology)
Women flute players in art	Flute players in art
Women stringed instrument players in art	Stringed instrument players in art
Yuit Eskimo women	Yuit Eskimos
African American women orators	African American orators
Developmentally disabled women	Developmentally disabled
African American women athletes	African American athletes
African American women authors	African American authors
African American women composers	African American composers
African American women executives	African American executives
African American women musicians	African American musicians
Basketball for women	Basketballs
Bodybuilding for women	Bodybuilding
Children of women prisoners	Children of prisoners
Chinese American women	Chinese Americans
Church work with female juvenile delinquents	Church work with juvenile delinquents
Cricket for women	Cricket
Fascism and women	Fascism
Flag football for women	Flag football
Golf for women	Golf
Greek American women	Greek Americans
Irish American women	Irish Americans
Lacrosse for women	Lacrosse
Libraries and women	Libraries
Mass media and women	Mass media
Mexican American women	Mexican Americans
Minority women	Minorities
Minority women in motion pictures	Minorities in motion pictures
Monasticism and religious orders for women	Monasticism and religious orders
Buddhist monasticism and religious orders for women	Buddhist monasticism and religious orders
Monasticism and religious orders for women (Canon law)	Monasticism and religious orders (Canon law)
Occupational training for women	Occupational training
Outdoor recreation for women	Outdoor recreation
Public speaking for women	Public speaking
Running for women	Running
Self-defense for women	Self-defense
Self-employed women	Self-employed
Soccer for women	Soccer
Softball for women	Softball
Speedball for women	Speedball
Sport clothes for women	Sport clothes
Sports for women	Sports
Swimming for women	Swimming
Tailoring (Women's)	Tailoring
Track and field for women	Track and field
Volleyball for women	Volleyball
Women, Aboriginal Australian	Aboriginal Australians
Baptist women	Baptists
Buddhist women	Buddhists
Women, Germanic	Germanic peoples
Hindu women	Hindus
Lutheran women	Lutherans
Mennonite women	Mennonites
Methodist women	Methodists
Women, Palestinian Arab	Palestinian Arabs
Quaker women	Quakers
Sikh women	Sikhs
Women authors, Arab	Authors, Arab
Women authors, Austrian	Authors, Austrian
Women authors, Black	Authors, Black
Women authors, Canadian	Authors, Canadian
Women authors, Chinese	Authors, Chinese
Women authors, Finnish	Authors, Finnish
Women authors, French	Authors, French
Women authors, Italian	Authors, Italian
Women authors, Kannada	Authors, Kannada
Women authors, Panamanian	Authors, Panamanian
Women authors, Panjabi	Authors, Panjabi
Women authors, Scandinavian	Authors, Scandinavian
Women authors, South African	Authors, South African
Women authors, Swedish	Authors, Swedish
Women authors, Telugu	Authors, Telugu
Women authors, West Indian	Authors, West Indian
Women dramatists, American	Dramatists, American
Women in journalism	Journalism
Women novelists, American	Novelists, American
Women novelists, English	Novelists, English
Women novelists, French-Canadian	Novelists, French-Canadian
Women novelists, Spanish	Novelists, Spanish
Women poets, Arab	Poets, Arab
Women poets, Chinese	Poets, Chinese
Women's encyclopedias and dictionaries, Chinese	Encyclopedias and dictionaries, Chinese
Women's encyclopedias and dictionaries, Japanese	Encyclopedias and dictionaries, Japanese
Women's exchanges	Exchange
Women dramatists, English	Dramatists, English
Women authors, Urdu	Authors, Urdu
Architecture and women	Architecture
Women authors, European	Authors, European
African American women artists	African American artists
Women authors, Portuguese	Authors, Portuguese
African American women poets	African American poets
Women poets, American	Poets, American
Women authors, Spanish American	Authors, Spanish American
Cycling for women	Cycling
African American women diplomats	African American diplomats
Women novelists, Norwegian	Novelists, Norwegian
Women authors, Norwegian	Authors, Norwegian
Women poets, Spanish American	Poets, Spanish American
Women authors, Lithuanian	Authors, Lithuanian
Women authors, Danish	Authors, Danish
Women authors, Korean	Authors, Korean
Women in social work education	Social work education
Television and women	Television
Weight training for women	Weight training
Women authors, Swiss	Authors, Swiss
Women authors, Australian	Authors, Australian
African American women chemists	African American chemists
Danish American women	Danish Americans
Women, Swahili-speaking	Swahili-speaking peoples
Norwegian American women	Norwegian Americans
Women authors, German	Authors, German
Blind women	Blind
Finnish American women	Finnish Americans
Taoist women	Taoists
Women's encyclopedias and dictionaries, German	Encyclopedias and dictionaries, German
Cuban American women	Cuban Americans
Women poets, Spanish	Poets, Spanish
Women authors, Spanish	Authors, Spanish
Women novelists, Catalan	Novelists, Catalan
Pacific Islander American women	Pacific Islander Americans
Women's encyclopedias and dictionaries, Korean	Encyclopedias and dictionaries, Korean
Hawaiian women	Hawaiians
Women authors, African	Authors, African
Women authors, Bengali	Authors, Bengali
Judo for women	Judo
Slavic American women	Slavic Americans
Women authors, Hindi	Authors, Hindi
Women authors, Assamese	Authors, Assamese
Women, Tonga (Zambezi)	Tonga (Zambezi people)
Women authors, Commonwealth	Authors, Commonwealth
Women, Viking	Vikings
Women authors, Caribbean	Authors, Caribbean
Women authors, Dutch	Authors, Dutch
Women in synagogues	Synagogues
Women authors, Iranian	Authors, Iranian
Women, Samoan	Samoans
Portuguese American women	Portuguese Americans
Women composers, Black	Composers, Black
Women, Burmese	Burmese
Women, Pushtun	Pushtuns
Women poets, Russian	Poets, Russian
Mentally ill women	Mentally ill
Women poets, Ukrainian	Poets, Ukrainian
African American women clergy	African American clergy
Women artists, Black	Artists, Black
National Women in Agriculture Day	National Agriculture Day
Women poets, English	Poets, English
Hispanic American women artists	Hispanic American artists
Helplessness (Psychology) in women	Helplessness (Psychology)
African American women civil rights workers	African American civil rights workers
Women, Bedouin	Bedouins
Armenian American women	Armenian Americans
African American women cooks	African American cooks
African American women mathematicians	African American mathematicians
Women poets, Brazilian	Poets, Brazilian
Achievement motivation in women	Achievement motivation
Women poets, Irish	Poets, Irish
Women poets, Korean	Poets, Korean
Women authors, South Asian	Authors, South Asian
Inuit women	Inuit
Women poets, Peruvian	Poets, Peruvian
Métis women	Métis
Pueblo women	Pueblos
Taos women	Tao
Aleut women	Aleuts
Crow women	Crows
Eskimo women	Eskimos
Fox women	Foxes
Inca women	Incas
Aztec women	Aztecs
Maya women	Mayas
Ukrainian American women	Ukrainian Americans
Women, Basque	Basques
Mexican American women agricultural laborers	Mexican American agricultural laborers
Women novelists, Japanese	Novelists, Japanese
Women novelists, Australian	Novelists, Australian
Women novelists, Argentine	Novelists, Argentine
Women novelists, French	Novelists, French
Women novelists, German	Novelists, German
Hmong American women	Hmong Americans
African American women in the professions	African Americans in the professions
African American women law teachers	African American law teachers
Women, Tuareg	Tuaregs
Vietnamese American women	Vietnamese Americans
African American women novelists	African American novelists
Chinese American women in literature	Chinese American literature
African American women social reformers	African American social reformers
Hispanic American women in literature	Hispanic Americans in literature
Women poets, Italian	Poets, Italian
Women authors, Mexican	Authors, Mexican
Museums and women	Museums
Hockey for women	Hockey
Married women in literature	Married people in literature
Women authors, Argentine	Authors, Argentine
Amish women	Amish
Mexican American women in literature	Mexican Americans in literature
Minority women in literature	Minorities in literature
German American women	German Americans
Women with disabilities in literature	People with disabilities in literature
Women, Torres Strait Islander	Torres Strait Islanders
Women social workers, Black	Social workers, Black
Women college teachers, Black	College teachers, Black
African American women journalists	African American journalists
Discrimination against overweight women	Discrimination against overweight persons
Women, Aboriginal Australian, in literature	Aboriginal Australian literature
Women, Black, in literature	Black in literature
Women artists in literature	Artists in literature
Women authors in literature	Authors in literature
Women detectives in literature	Detectives in literature
Women healers in literature	Healers in literature
Women intellectuals in literature	Intellectuals in literature
Women pioneers in literature	Pioneers in literature
Women prisoners in literature	Prisoners in literature
Women soldiers in literature	Soldiers in literature
Women spies in literature	Spies in literature
Women travelers in literature	Travelers in literature
Working class women in literature	Working class in literature
African American women abolitionists	African American abolitionists
Women authors, Latin American	Authors, Latin American
Women authors, Chilean	Authors, Chilean
Sexual ethics for women	Sexual ethics
African American women astronauts	African American astronauts
African American women pioneers	African American pioneers
South Asian American women	South Asian Americans
Women, Nubian	Nubians
Women dramatists, Argentine	Dramatists, Argentine
Women dramatists, Spanish	Dramatists, Spanish
Older Mexican American women	Older Mexican Americans
Stress management for women	Stress management
Women poets, German	Poets, German
Women poets, Gujarati	Poets, Gujarati
Women poets, Urdu	Poets, Urdu
Women poets, Dominican	Poets, Dominican
Women authors, Vietnamese	Authors, Vietnamese
Women authors, Scottish	Authors, Scottish
Women authors, Indic	Authors, Indic
African American women legislators	African American legislators
Women authors, Irish	Authors, Irish
Women authors, Greek	Authors, Greek
Mentally ill women in literature	Mentally ill in literature
National socialism and women	National socialism
African American women air pilots	African American air pilots
Women authors, Galician	Authors, Galician
Women, Pygmy	Pygmies
African American women physicists	African American physicists
African American women physical scientists	African American physical scientists
African American women scientists	African American scientists
Asian American women artists	Asian American artists
Cooperativeness in women	Cooperativeness
Leadership in women	Leadership
Women authors, Egyptian	Authors, Egyptian
African American women healers	African American healers
African American women political activists	African American political activists
Filipino American women	Filipino Americans
Korean American women journalists	Korean American journalists
Hispanic American women in the professions	Hispanic Americans in the professions
Shooting for women	Shooting
Women poets, French	Poets, French
Filipino American women artists	Filipino American artists
Filipino American women authors	Filipino American authors
Asian American women in literature	Asian Americans in literature
African American women motion picture producers and directors	African American motion picture producers and directors
Women employees in literature	Employees in literature
African American women screenwriters	African American screenwriters
African American women school principals	African American school principals
Mexican American women college teachers	Mexican American college teachers
African American women college teachers	African American college teachers
African American women college administrators	African American college administrators
Women, Berber	Berbers
Nicaraguan American women	Nicaraguan Americans
Muslim women in art	Muslims in art
Women, White, in art	White in art
Older Hispanic American women	Older Hispanic Americans
Women, Arab	Arabs
African American women in advertising	African Americans in advertising
Women heroes in art	Heroes in art
Women authors, Brazilian	Authors, Brazilian
Women poets, Basque	Poets, Basque
Women, Bantu-speaking	Bantu-speaking peoples
Hawaiian women in art	Hawaiian art
Women, Prehistoric, in art	Art, Prehistoric
Women musicians in art	Musicians in art
Women prophets in art	Prophets in art
Working class women in art	Working class in art
Women authors, Israeli	Authors, Israeli
Women's hospitals	Hospitals
Computers and women	Computers
Anabaptist women	Anabaptists
Women authors, Ukrainian	Authors, Ukrainian
Hispanic American women television personalities	Hispanic American television personalities
AIDS (Disease) in women	AIDS (Disease)
Women poets, Vietnamese	Poets, Vietnamese
Women dramatists, Brazilian	Dramatists, Brazilian
Anxiety in women	Anxiety
Women authors, Filipino	Authors, Filipino
Women poets, Filipino	Poets, Filipino
African American women lawyers	African American lawyers
Osteoporosis in women	Osteoporosis
Women teachers, Black	Teachers, Black
Radio and women	Radio
Women dramatists, German	Dramatists, German
Women journalists in motion pictures	Motion picture journalists
Women authors, Tunisian	Authors, Tunisian
Women authors, Slovenian	Authors, Slovenian
Indian women in literature	Indian literature
Iranian American women	Iranian Americans
Women authors, Dominican	Authors, Dominican
Women authors, Ecuadorian	Authors, Ecuadorian
Women artists, Aboriginal Australian	Artists, Aboriginal Australian
Women authors, Flemish	Authors, Flemish
African American women physicians	African American physicians
East Indian American women	East Indian Americans
Pakistani American women	Pakistani Americans
Cuban American women television personalities	Cuban American television personalities
Guatemalan American women	Guatemalan Americans
African American women school superintendents	African American school superintendents
Women authors, Central American	Authors, Central American
Women poets, Israeli	Poets, Israeli
Women authors, New Zealand	Authors, New Zealand
Basque American women	Basque Americans
Carrier women	Carriers
Women authors, Hungarian	Authors, Hungarian
Episcopalian women	Episcopalians
Women authors, French-Canadian	Authors, French-Canadian
Diabetes in women	Diabetes
Women, Black, in art	Art, Black
African American women tennis players	African American tennis players
Egyptian American women	Egyptian Americans
Women, Tibetan	Tibetans
Fly fishing for women	Fly fishing
Women authors, Nigerian	Authors, Nigerian
African American women educators	African American educators
African American women surgeons	African American surgeons
Women poets, Persian	Poets, Persian
African American women entertainers	African American entertainers
Social work with minority women	Social work with minorities
Women authors, Hausa	Authors, Hausa
Women dramatists, Irish	Dramatists, Irish
Women, Baka	Baka
Women drummers (Musicians) in art	Drummers (Musicians) in art
Mexican American women in the professions	Mexican Americans in the professions
Women poets, Greek	Poets, Greek
Christian women (Disciples of Christ)	Christians (Disciples of Christ)
