W | M | G
--------------------------------
Eating disorders in men	Eating disorders in women	Eating disorders
Asian American men	Asian American women	Asian Americans
Depression in men	Depression in women	Depressions
Gifted men	Gifted women	Gifted persons
Latter Day Saint men	Latter Day Saint women	Latter Day Saints
Learning disabled men	Learning disabled women	Learning disabled
African American men in motion pictures	African American women in motion pictures	African Americans in motion pictures
Bahai men	Bahai women	Bahais
Puritan men	Puritan women	Puritans
African American bisexual men	African American bisexual women	African American bisexual people
Protestant men	Protestant women	Protestants
Homeless men	Homeless women	Homeless persons
Grief in men	Grief in women	Grief
Working class men	Working class women	Working class
Men, Black, in motion pictures	Women, Black, in motion pictures	Black people in motion pictures
Men, White, in motion pictures	Women, White, in motion pictures	White people in motion pictures
Men in education	Women in education	Education
Seventh-Day Adventist men	Seventh-Day Adventist women	Seventh-Day Adventists
Men and literature	Women and literature	Literature
Obesity in men	Obesity in women	Obesity
Jewish men in literature	Jewish women in literature	Jewish literature
Asian American men in motion pictures	Asian American women in motion pictures	Asian Americans in motion pictures
Indian men	Indian women	Indians
Married men	Married women	Married people
Muslim men	Muslim women	Muslims
Christian education of young men	Christian education of young women	Christian education of young people
Single men in literature	Single women in literature	Single people in literature
Presbyterian men	Presbyterian women	Presbyterians
Upper class men	Upper class women	Upper class
Men in music	Women in music	Music
Older men in art	Older women in art	Arts and older people
Sexual minority men	Sexual minority women	Sexual minorities
Italian American men	Italian American women	Italian Americans
Arab American men	Arab American women	Arab Americans
Indigenous men	Indigenous women	Indigenous peoples
Men, Black	Women, Black	Black
Pentecostal men	Pentecostal women	Pentecostals
Transgender men	Transgender women	Transgender people
African American men in comics	African American women in comics	African Americans in comics
African American men	African American women	African Americans
Older men	Older women	Older people
Diving for men	Diving for women	Diving
Divorced men	Divorced women	Divorced people
Etiquette for men	Etiquette for women	Etiquette
Exercise for men	Exercise for women	Exercise
Gymnastics for men	Gymnastics for women	Gymnastics
Men	Women	Human beings
Men, White	Women, White	White
Men in art	Women in art	Art
Men in church work	Women in church work	Church work
Men in literature	Women in literature	Literature
Men in motion pictures	Women in motion pictures	Motion pictures
Men's clothing	Women's clothing	Clothing workers
Middle-aged men	Middle-aged women	Middle-aged persons
Physical fitness for men	Physical fitness for women	Physical fitness
Sex instruction for men	Sex instruction for women	Sex instruction
Single men	Single women	Single people
Young men	Young women	Young adults
Middle class men	Middle class women	Middle class
Men in mass media	Women in mass media	Mass media
Hispanic American men	Hispanic American women	Hispanic Americans
Men in popular culture	Women in popular culture	Popular culture
Men's dreams	Women's dreams	Dreams
Poor men	Poor women	Poor
Bisexual men	Bisexual women	Bisexual people
Heterosexual men	Heterosexual women	Heterosexuals
African American men in literature	African American women in literature	African Americans in literature
Overweight men	Overweight women	Overweight persons
African American young men	African American young women	African American young adults
Young men in literature	Young women in literature	Young adults in literature
Self-perception in men	Self-perception in women	Self-perception
Japanese American men	Japanese American women	Japanese Americans
Deaf men	Deaf women	Deaf
Men with disabilities	Women with disabilities	People with disabilities
Men's mass media	Women's mass media	Mass media
African American men in art	African American women in art	African American art
Men, White, in literature	Women, White, in literature	White in literature
Men in advertising	Women in advertising	Advertising
Motion pictures for men	Motion pictures for women	Motion pictures
Korean American men	Korean American women	Korean Americans
Self-esteem in men	Self-esteem in women	Self-esteem
Body image in men	Body image in women	Body image
African American men in popular culture	African American women in popular culture	African Americans in popular culture
Christian men	Christian women	Christians
Catholic men	Catholic women	Catholics
HIV-positive men	HIV-positive women	HIV-positive persons
Motion pictures and men	Motion pictures and women	Motion pictures
Cancer in men	Cancer in women	Cancer
Violence in men	Violence in women	Violence
Men with mental disabilities	Women with mental disabilities	People with mental disabilities
Male friendship in motion pictures	Female friendship in motion pictures	Friendship in motion pictures
Generative organs, Male	Generative organs, Female	Generative organs
Infertility, Male	Infertility, Female	Infertility
Male livestock	Female livestock	Livestock
Male nude in art	Female nude in art	Nude in art
Male orgasm	Female orgasm	Orgasm
Male friendship	Female friendship	Friendship
Male juvenile delinquents	Female juvenile delinquents	Juvenile delinquents
Male friendship in literature	Female friendship in literature	Friendship in literature
Masculine names	Feminine names	Names
Male authors, Russian	Women authors, Russian	Authors, Russian
Male comedians	Women comedians	Comedians
Male caregivers	Women caregivers	Caregivers
Male social workers	Women social workers	Social workers
Male musicians	Women musicians	Musicians
Male prisoners	Women prisoners	Prisoners
Male preschool teachers	Women preschool teachers	Preschool teachers
African American male college students	African American women college students	African American college students
Male immigrants	Women immigrants	Immigrants
Male teachers	Women teachers	Teachers
Male cooks	Women cooks	Cooks
Male artists	Women artists	Artists
Male blue collar workers	Women blue collar workers	Blue collar workers
Male athletes	Women athletes	Athletes
Male white collar workers	Women white collar workers	White collar workers
Male long-distance runners	Women long-distance runners	Long-distance runners
Male lawyers	Women lawyers	Lawyers
Male college athletes	Women college athletes	College athletes
Navajo male weavers	Navajo women weavers	Navajo weavers
Male murderers	Women murderers	Murderers
African American male teachers	African American women teachers	African American teachers
Male Rugby Union football players	Women Rugby Union football players	Rugby Union football players
Male consumers	Women consumers	Consumers
Male dancers	Women dancers	Dancers
Male nurses	Women nurses	Nurses
Male weavers	Women weavers	Weavers
Male authors	Women authors	Authors
Male authors, English	Women authors, English	Authors, English
Male employees	Women employees	Employees
Male college students	Women college students	College students
Male dramatists	Women dramatists	Dramatists
Male authors, American	Women authors, American	Authors, American
African American male singers	African American women singers	African American singers
Male singers	Women singers	Singers


W | M
--------------------------------
Cantatas (Men's voices)	Cantatas (Women's voices)
Church group work with men	Church group work with women
Heterosexual men in motion pictures	Heterosexual women in motion pictures
Men's health services	Women's health services
Men's choirs	Women's choirs
Preaching to men	Preaching to women
Urban men	Urban women
Gullah men	Gullah women
Navajo men	Navajo women
Men, Maasai	Women, Maasai
Hispanic American bisexual men	Hispanic American bisexual women
Men in comics	Women in comics
Cantatas, Sacred (Men's voices)	Cantatas, Sacred (Women's voices)
Cantatas, Secular (Men's voices)	Cantatas, Secular (Women's voices)
Choruses, Sacred (Men's voices)	Choruses, Sacred (Women's voices)
Choruses, Sacred (Men's voices, 4 parts)	Choruses, Sacred (Women's voices, 4 parts)
Choruses, Sacred (Men's voices, 4 parts), Unaccompanied	Choruses, Sacred (Women's voices, 4 parts), Unaccompanied
Choruses, Sacred (Men's voices), Unaccompanied	Choruses, Sacred (Women's voices), Unaccompanied
Choruses, Sacred (Men's voices) with orchestra	Choruses, Sacred (Women's voices) with orchestra
Choruses, Sacred (Men's voices) with organ	Choruses, Sacred (Women's voices) with organ
Choruses, Sacred (Men's voices) with piano	Choruses, Sacred (Women's voices) with piano
Choruses, Secular (Men's voices)	Choruses, Secular (Women's voices)
Choruses, Secular (Men's voices, 4 parts), Unaccompanied	Choruses, Secular (Women's voices, 4 parts), Unaccompanied
Choruses, Secular (Men's voices), Unaccompanied	Choruses, Secular (Women's voices), Unaccompanied
Choruses, Secular (Men's voices) with band	Choruses, Secular (Women's voices) with band
Choruses, Secular (Men's voices) with electronics	Choruses, Secular (Women's voices) with electronics
Choruses, Secular (Men's voices) with orchestra	Choruses, Secular (Women's voices) with orchestra
Choruses, Secular (Men's voices) with piano	Choruses, Secular (Women's voices) with piano
Choruses, Secular (Men's voices) with string orchestra	Choruses, Secular (Women's voices) with string orchestra
Choruses (Men's voices)	Choruses (Women's voices)
Choruses (Men's voices), Unaccompanied	Choruses (Women's voices), Unaccompanied
Choruses (Men's voices) with piano	Choruses (Women's voices) with piano
Church work with men	Church work with women
Masses (Men's voices)	Masses (Women's voices)
Men's clothing industry	Women's clothing industry
Photography of men	Photography of women
Requiems (Men's voices)	Requiems (Women's voices)
Sex discrimination against men	Sex discrimination against women
Skiing for men	Skiing for women
Wild men	Wild women
Wild men in literature	Wild women in literature
Working-men's clubs	Working-women's clubs
Young Men's Christian associations	Young Women's Christian associations
Men's studies	Women's studies
Jewish men	Jewish women
Abusive men	Abusive women
Masses (Men's voices), Unaccompanied	Masses (Women's voices), Unaccompanied
Social work with men	Social work with women
Older men in literature	Older women in literature
Men in the Bible	Women in the Bible
Abused men	Abused women
Men on television	Women on television
Psychologically abused men	Psychologically abused women
Wild men in art	Wild women in art
Rural men	Rural women
Choruses, Sacred (Men's voices) with instrumental ensemble	Choruses, Sacred (Women's voices) with instrumental ensemble
Choruses, Secular (Men's voices) with instrumental ensemble	Choruses, Secular (Women's voices) with instrumental ensemble
Sexual harassment of men	Sexual harassment of women
Male friendship on television	Female friendship on television
Male impersonators	Female impersonators
Male impersonators in motion pictures	Female impersonators in motion pictures
Masculine beauty (Aesthetics)	Feminine beauty (Aesthetics)
